
Error with upload your image , sorry!=نأسف ! حدث خطأ في عمليه التحميل
Add a new image=أضف صورة جديده , يمكنك الذهاب إلى تبويب قوالب لإضافه صورة قمت برفعها مسبقا
defaultimage=القالب الإفتراضي
image=صورة
login_form=نموذج تسجيل الدخول
register_form=نموذج تسجيل
reset_password_form=نموذج إعادة الرقم السري
member=أعضاء
Welcom=أهلا
Last login=آخر زياره في 
member=المشترك
is now as=هو الآن كـ
not active=غير فعال
active=فعال
privileges=صلاحيات
admin_full=مدير بكافة الصلاحيات
admin_design=مدير بصلاحيات مصمم
admin_developer=مدير بصلاحيات مطور
admin_editor=مدير بصلاحيات محرر
user not active=لم يتم تفعيل الإشتراك الخاص بك 
Add new member=إضافه مشترك جديد
Active user message=تم تفعيل هذا الحساب مسبقا
After active user message=شكرا ... تم تفعيل الحساب الخاص بك 
msg_name_alredy_register=هذا المشترك موجود مسبقا
msg_email_alredy_register=هذا البريد موجود مسبقا 
msg_must_fill_name=يجب تعبئة إسم المستخدم 
msg_must_fill_pass=يجب تعبئة الرقم السري
msg_must_fill_valid_email=البريد المدخل غير صحيح
msg_register_done=تمت عملية التسجيل بنجاح 
subject email active your account=تفعيل الإشتراك في موقع 
content email active your account=محتوى البريد الإلكتروني والذي يحتوي على رابط تفعيل الحساب  وتستخدم هذه الشيفره لإستبدالها بعنوان الرابط ((link))
invaled_password=رقم سري خاطئ
changed_password_done=تمت عمليه تغيير الرقم السري بنجاح
changed image done=عمليه تغيير الصوره الرمزيه تمت بنجاح
image file invaled=الصورة الرمزيه التي تحاول رفعها غير صحيحه
login error=خطأ في اسم المستخدم أو كلمة المرور
send by email information done=تم إرسال بيانات الدخول إلى بريدك الإلكتروني 
email not in our data=هذا البريد غير مشترك معنا 
changed information done=تمت عملية تحديد البيانات بنجاح 
Not currently a member= لايوجد لديك إشتراك بعد ؟ 
Create a Username=إسم المستحدم
Create a Password=الرقم السري
Re-enter Password=أعد كتابة الرقم السري
E-mail Address=البريد الإلكتروني
Sign Up=إشترك
Already a member=مشترك معنا ؟
Forgot account=نسيت كلمة المرور ؟
you are login alredy=لقد قمت بعملية التسجيل مسبقا !
right-left=right
@@@1=أهلا
@@@2=خروج
@@@3=ملفي 
@@@4=الرئيسيه
@@@5=العملاء
@@@6=الموظفون
@@@7=اللغات
@@@8=المدير
@@@9=ملف الإكسل
@@@10=أرسل
@@@11=مطلوب
@@@12=يجب أن يكون الملف المرفق أكسل ومرتب على حسب الترتيب الذي تم الإتفاق عليه
@@@13=التحكم وإدارة العملاء
@@@14=عميل تم إضافته بنجاح
@@@15=جاري إرسال البيانات .. الرجاء الإنتظار
@@@16=موظف
@@@17=مدير
@@@18=موقوف
@@@19=الإسم الكامل
@@@20=العنوان
@@@21=رقم الموبايل
@@@22=تاريخ الميلاد
@@@23=معلومات إضافيه
@@@24=يجب أن تكون جميع البيانات صحيحه وتتحمل أنت كامل المسؤوليه أمام القضاء
@@@25=شركة وائ العيساوي
@@@26=المعلومات الشخصيه
@@@27=جميع العملاء
@@@28=Phone call
@@@29=Meeting
@@@30=Pay
@@@31=date
@@@32=contract
@@@33=finish
@@@34=
@@@35=
@@@36=
@@@37=
@@@38=
@@@39=
@@@40=

rtl_ltr=rtl
right_left=right
left_right=left
arrowcss=◂
before_after=before
arrowrtl=&#9668
Control panel=لوحة التحكم
Page=صفحة 
Style=تنسيق
Themes=مظهر
Box=صندوق
Widget=إضافات
Edit CSS=تنسيق
Go to controlpanel , new page=الذهاب إلى لوحة التحكم الرئيسيه , ستفتح في صفحة جديده
Result show here for any change=النتائج تظهر هنا لأي تعديل أو تغيير تقوم به
this page option=خيارات هذه الصفحه, الصفحة التي أنت بها
Style or css live editor=تعديل التنسيق المباشر ,
chnage your site theme=تغيير التصميم أو المظهر للموقع
add or delete or edit box in right or left colmuns=التحكم في الصناديق الموجوده داخل الجوانب
add or delete or edit widget in header or footer=التحكم في الإضافات الموجوده في الترويسه أو ذيل الموقع
Close this front panel=إغلاق اللوحة الأماميه هذه 
Plugin=الإضافه
Position=المكان
Link To=مرتبط مع
select=إختر
relative=نسبي
fixed=مثبت في موضعه
static=غير متحرك
Page= الصفحة
Header=الترويسه
Content=المحتوى
Footer=الذيل
run in=تظهر في
All=الكل
This layout only=هذه المجموعه
This Page only=هذه الصفحة 
show Powers=صلاحيات الظهور لـ
Add a new box=أضف صندوق جديد
Box title=عنوان الصندوق
Box content=محتوى الصندوق
Box Style=إطار الصندوق
Column side=يظهر في العمود
Left=اليسار
Right=اليمين
Add Box now=<strong>أضف </strong>صندوق الآن
Add widget now=<strong>إعتمد </strong>الإضافه الآن
edit this plugin file advance=محرر تعديل هذه الإضافه , للمحترفين فقط
Page option=خيارات هذه الصفحة
Layout setting=قالب العرض
Site option=خيارات موقعك الإلكتروني
Postion setting=مكان الموقع
postion_center=في منتصف المتصفح
postion_left=على يسار المتصفح
postion_right=على يمين المتصفح
Drag and drop this box=إسحب هذا الصندوق وأفلته في مكان آخر
Right click to show menu option=كليك يمين لإظهار قائمة الخيارات
Click to edit this page title=كليك يسار لتعديل عنوان الصفحة
Click to edit this page content=كليك لتعديل المحتوى
Quick change image & color=تغيير صور التصميم بسهوله
Select section and click clear image & color=إختر جزء من القائمة لحذف صورة التصميم واللون
Background=الخلفيه
left box header=ترويسة الصندوق الأيسر
right box header=ترويسة الصندوق الأيمن
Clear image & color=<strong>حذف</strong> الصورة واللون
you can pick image to= يمكنك إختيار صورة لـ
Change=تغيير
Uploading image...=جاري تحميل الصورة
Advance Editor CSS Theme=المحرر المتطور المباشر لتنسيق المظهر
Select section to modify=إختر الجزء الذي تريد تنسيقه     
Live Style Editor=<strong>المحرر </strong> المباشر
Restore Orginal Style=<strong>إعادة </strong> التنسيق الأساسي 
header menu=القائمة العلويه
search=البحث
left_box=الصندوق الأيسر
right_box=الصندوق الأيمن
Quick change font properties=تغيير إعدادات الخط وتنسيقه بسهوله
Select section and modify font=إختر الجزء  ثم قم بتعديل الخصائص
Select section= إختر القسم
Select proprtis=إختر الخاصيه 
Title page=عنوان الصفحة
Content page=محتوى الصفحة
Links=الروابط
Title box=عنوان الصندوق
Content box= محتوى الصندوق
Sample text style=عينة لمعاينة التنسيق
Save Changes Style=<strong>حفظ </strong> التعديلات
from here you can change theme for your site=من هنا يمكنك إختيار المظهر المانسب لموقعك الإلكتروني
Choose theme=إختر التصميم المناسب ثم إضغط على تطبيق أو إلغاء
general properties=خصائص عامه
settings=إعدادات
save settings=<strong>حفظ </strong> الإعدادات الجديده
withbox=بدون تصميم
withoutbox=بدون صندوق
widget controls=التحكم بالعنصر
templates=قوالب
cancel and Close= إغلاق وإلغاء التعديلات التي تمت
Uploading=تحميل
Drop files here to upload=ألقي الصورة هنا لتحميلها
Click to edit=كليك يسار للتعديل
apply=تطبيق
Saving...=حفظ ...
add this widget to=أضف إلى 
control setting your site=التحكم في إعدادات الموقع , شعار الموقع والعنوان وأمور أخرى
controlplugin=التحكم في الإضافه
code edit=تحرير شيفرة المصدر
Update widget done=تمت عمليه التحديث
Delete done=تمت عمليه الحذف
Done sort=حفظ الترتيب بنجاح
Saved style Success=حفظ  التنسيق بنجاح
Done Update Layout Postion=تم التطبيق
Done Update Layout View=تم إعتماد القالب
Success apply theme=تم تطبيق المظهر الجديد
Add widget done=تم نشر الإضافه المختاره
Drag Editor=حرك المحرر
Click to Bold=خط غامق
Click to Italic=خط مائل
Click to Underline=تحته خط
Left Align=محاذاة لليسار
Center Align=مركز محاذاة
Right Align=محاذاة لليمين
Justify Align=ضبط المحاذاة
Insert Ordered List=إدراج قائمة مرتبه
Insert Unordered List=إدراج قائمة غير مرتبه
Click to Subscript=منخفض عن النص
Click to Superscript=مرتفع عن النص
Click to Strike Through=خط في المنتصف
Remove Formatting=إزالة التنسيق
Indent Text=مسافه بادئه
Remove Indent=حذف المسافه البادئه
Horizontal Rule=خط أفقي
Select Font Size=حجم الخط
Select Font Family=نوع الخط
Select Font Format=تنسيق الخط
Change Text Color=لون النص
Change Background Color=لون خلفية النص
Save this content=حفظ التعديلات
Add Image=أضف صورة
Edit HTML=شيفرة المصدر
Add Link=أضف رابط
Remove Link=حذف الرابط
press enter to save or ESC to cancel=إضغط إدخال للحفظ وخروج لإلغاء التغييرات
bring_to_front=سحب للأعلى
send_to_back=إرسال للخلف
bring_forward=سحب أعلى
send_backward=إرسال خلف
refresh=إعادة تحميل
pick template and select action=إختر القالب من القائمة ثم إضغط على الأمر المناسب
Edit advance=تعديل متقدم
you well delete this template and all widget use it, are you sure?=ستقوم بحذف هذا القالب وجميع الإضافات التي تستخدم القالب الذي إخترت حذفه , هل أنت موافق على الحذف ؟
you cant Delete the defult template!=لا يمكنك حذف القالب الإفتراضي  !
no controlpanel for this widget=لايوجد وحدة تحكم لهذا العنصر 
my account=حسابي
my account setting=معلومات وتحكم في حسابك ولغه عرض لوحة التحكم 
Language choose=اختر لغة لوحة التحكم 
Generate Style Editor=<strong>تحزيم </strong> التنسيق الحالي
generate Editor CSS Theme=لحفظ التنسيق الحالي وجعله نسخه داخل قسم مظهر قم بأخذ صورة للتصميم ثم إضغط على تحزيم التنسيق الحالي وإختر صورة التصميم التي إخترتها 
Sfhati Control panel= لوحة تحكم صفحتي
User=المستخدم
Setting Description=نبذه عن الإعادا
Setting Value= القيمة
Setting Default Value=القيمة الإفتراضيه
Setting Type= نوع الإعداد
normal text= حقل نصي
text erea= منطقة نصيه
editor= محرر
true & false= نعم , لا
compo 1 to 100= قائمة من 1 إلى 100
hiden= مخفي
Use it in template?= إستخدم الإعداد في القالب ؟
Yes= نعم
No= لا
Page title= عنوان الصفحة
Description= نبذه
Add/Remove editor= أضف \ أخفي المحرر
Content= محتوى الصفحة
URL= رابط
Image path= صورة
Sub under page id= تفرع من  صفحة
Reset= إعادة
Cancel=إلغاء
cancel update= إلغاء التعديلات
Sorry we have an error, <br> try agian= نأسف هناك خطأ , <br> جرب مرة أخرى
Loading...= تحميل ...
saving...= جاري الحفظ ...
Click to edit...= أنقر للتعديل
Please Select= الرجاء الإختيار
Close= أغلق
yes i wont delete= نعم أريد حذف
template= قالب
to do it= لتنفيذ العمليه
User Name= إسم المستخدم
Password= الرقم السري
Forget password= نسيت الرقم السري
Login= تسجيل الدخول
Add new= أضف جديد
please try agean= الرجاء المحاوله مرة أخرى
permission is denain!= ليس لديك صلاحيات
Add note= أضف ملاحظه
Upload Now= عدل الآن
Link= رابط
Accept template= طبق هذا القالب
Manage template= إدارة القالب
About template=عن القالب
Delete template= حذف القالب
Preview template= معاينه القالب
Active/Deactive= تفعيل \ عدم تفعيل
File is valid, and was successfully uploaded= تم رفع الملف بنجاح
Possible file upload attack!= لايمكن قبول هذا الملف
Update template site to= تعديل قالب الموقع لـ
done...= تم ...
Delete template= حذف القالب
Update new style= تطبيق تصميم جديد
sort done!= تم الترتيب
Add new Page= أضف صفحة جديده
Show pages by= أظهر الصفحات حسب
template= القالب
[AND/OR] place= و \ أو المكان
Rows Nu= عدد الصفوف
GO=نفذ
Nu=رقم
Page title=عنوان الصفحة
Sort=ترتيب
Place=المكان
Template=القالب
Powers=صلاحيات
Add sub=أضف صفحة متفرعه 
Active=تفعيل
Edit=تعديل
Delete=حذف
Pages=الصفحات
show sub pages=أظهر الصفحات الفرعيه
P_Public=عام
P_Login= للمسجلين
P_Not Login=غير مسجل
Logout= خروج
Home= الرئيسيه
Site template= القوالب
Pages editor= مدير الصفحات
Site setting= إعدادات
Plugin`s= الإضافات
Welcome= أهلا
Choose=إختر
Value=القيمة
Update= تعديل
Add New=أضف جديد
Advance=متقدم
Reset_defult=أعد القيمة الإفتراضيه
Pages=الصفحات
all pages=عدد الصفحات
Zero mean under root=صفر تعني قائمة رئيسيه
Save note= إحفظ الملاحظه
Your name= الإسم
Text of the note= نص الملاحظه
Color= اللون
Template name= إسم القالب
Plugin name=إسم الإضافة
Delete plugin=حذف الإضافة
About plugin=عن الإضافة
Manage plugin= التحكم
Click on=إضغط على
plugin=إضافة
upload complete=تمت عملية تحميل
uploading=جاري التحميل
Upload new template=حمّل قالب جديد
Upload new plugin=حمل إضافه جديده
x__manag_template=القوالب
x__plugin= الإضافات
x__sett=إعدادات
x__page=مدير الصفحات
main menu=الرئيسيه
Options=خيارات
Last login=آخر زياره في
Help=مساعده
Language=اللغه
one column=عمود واحد
tow column=عمودين
three column=ثلاثة أعمده
blank=صفحة فارغة
Email sitting=إعدادات البريد
upload_dir=مجلد الملفات
template_dir=مجلد القوالب
install=تنزيل
Read more=اقرأ المزيد
Statistic=إحصائيات
statistic page=صفحة الإحصائيات
Members=أعضاء
memper page=صفحة الأعضاء
Setting=إعدادات
Setting page=صفحة الإعدادات
Plugin=إضافات
Plugin control page=صفحة التحكم بالإضافات 
Main Domain=النطاق الرئيسي
Last login from=آخر تسجيل دخول من خلال
Disk Space Usage=المساحة الكليه
Monthly Bandwidth Transfer=نقل البيانات الشهري
Email Accounts=البريد الإلكتروني
Subdomains=النطاقات الفرعيه
Parked Domains=نطاقات موجهه
Addon Domains=نطاقات مضافه
FTP Accounts=حسابات FTP
SQL Databases=قواعد بيانات
Expired=إنتهاء بعد
Created=تسجيل في 
Account Information=معلومات الحساب
page managment add edit=التحكم بصفحات الموقع
email page=التحكم في البريد الإلكتروني إضافه وحذف
File manager=مدير الملفات
filemanager page=مدير ملفات متطور 
Version=النسخة
Page with out colums=بدون أعمدة
Page with colums=مع أعمده
Page with right colum=العمود الأيمن فقط
Page with left colum= العمود الأيسر فقط
Page with colums on right=الأعمده على اليمين
Page with colums on left=الأعمدة على اليسار
Blank=فارغ
admin=المدير
user=المسجلين
guest=الزوار
public=الجميع
Header Menu=قائمه علويه
Add new email=أضف حساب بريد إلكتروني جديد
emails=حسابات البريد الإلكتروني
Error=خطأ
Developed on &copy; Sfhati. All rights reserved=برمجة وتطوير <a href="http://sfhati.com" target="_blank">صفحتي</a> &copy; جميع الحقوق محفوظه
Email=البريد الإلكتروني
all emails=الحسابات البريديه المتوفره
Create=إنشاء
Install=تنصيب
Downloads=مرات التحميل
version=الإصدار
all plugins=عدد الإضافات
Plugin manage=التحكم بالإضافات
About=حول
Save=حفظ
Name=الإسم
Send=أرسل
delete_page=حذف هذه الصفحة وجميع الصفحات المتفرعه منها 
makehome_page=اجعل هذه الصفحة هي صفحة موقعك الرئيسيه 
permition_page0=صلاحيات مشاهدة هذه الصفحة متاحه للجميع 
permition_page1=صلاحيات مشاهدة هذه الصفحة متاحه للإدارة  فقط
permition_page2=صلاحيات مشاهدة هذه الصفحة متاحه للأعضاء فقط  
permition_page3=صلاحيات مشاهدة هذه الصفحة متاحه لغير المسجلين فقط 
permition_page4=صلاحيات مشاهدة هذه الصفحة متاحة للمشرفين فقط 
make=اجعل
control place page= تحكم في مكان ظهور هذه الصفحة , في أي قائمة تريد إظهار هذه الصفحة 
change site title=تغيير عنوان الموقع 
change site radio=زوايا دائريه لإطار الموقع
change site border=إطار  الموقع
change site chadow=ظل لإطار الموقع
change site margenstritch=محاذاة الأجزاء الرئيسيه , الترويسه والمحتوى والذيل وعرض كل جزء

change icon site=تغيير أيكونه الموقع 
save change title site=حفظ عنوان الموقع الجديد
pages=صفحات الموقع
caption=المسمى
U_small=صغير
U_midiom=وسط
U_large=كبير
U_required=مطلوب
U_optional=إختياري
U_length=الطول
U_min=أصغر
U_max=أكبر
U_number=رقمي
U_lette=نص
U_email=بريد إلكتروني
U_nospecialcaracters=لا يحتوي على رموز
U_telephone=هاتف
U_rege=قياسي
U_nothing=لاشيء
Save & Close=حفظ وإغلاق
New password=حقل رمز سري
New textarea=منطقه نصيه
New checkbox=إختيار متعدد
New file=رفع ملف
New radio=إختيار واحد من متعدد
add item=أضف عنصر جديد
delete item=حذف العنصر 
new item=عنصر جديد
Verify that you are a human=التحقق من أنك شخص 
U_drag=فم بسحب
into the circle=داخل الدائره
pencil=القلم
scissors=المقص
clock=الساعه
heart=القلب
note=الكتاب
new_text=أضف حقل نصي
new_password=أضف حقل رمز سري
new_textarea=أضف منطقه نصيه
new_checkbox=أضف خيارات متعدده
new_radio=أضف خيار من متعدد
new_select=أضف قائمة منسدله
new_list=أضف قائمة خيارات
new_file=أضف إمكانيه رفع ملف 
new_date_picker=أضف حقل تاريخ
new_form=حدد إعدادات النموذج
new_save=حفظ ونشر النموذج 
send form email notification=البريد الإلكتروني المعتمد لإرسال بيانات وتنبيهات النموذج 
send_database form_builder=حفظ البيانات المرسله من النموذج في 
database form_builder=قواعد البيانات 
msg_after_send=الرساله التي ستظهر بعد إرسال النموذج 
Thank you=شكرا لك
Success=تمت العمليه بنجاح
Error fancy captcha=الرجاء تأكيد أن المرسل شخص من خلال سحب الصورة المطلوبه 
Between=بين
and=و
characters allowed=عدد الحروف المسموح بها 
This field is required=هذا الحقل مطلوب تعبئته
Please select an option=الرجاء تحديد خيار 
This checkbox is required=الرجاء تحديد خيار 
Checks allowed Exceeded=أكبر عدد خيارات مسموح به 
Please select= الرجاء تحديد 
U_options= خيارات 
Your field is not matching= الحقل غير مطابق 
Invalid phone number=رقم الهاتف غير صحيح 
Invalid email address=البريد الذي أدخلته غير صحيح 
Invalid date, must be in YYYY-MM-DD format= التاريخ المدخل غير صحيح يجب أن يكون بهذه الصيغه YYYY-MM-DD
Numbers only= يسمح بالأرقام فقط 
Available= متاح
not Available=غير متاح
No special caracters allowed= لايسمح  بكتابه الرموز 
Letters only=يسمح بالأحرف اللاتينيه فقط 
form_builder=منشئ النماذج 
all record=عدد السجلات 
recordform=عارض النماذج
dont run in this page=لاتظهر في هذه الصفحة
sorry u cant do this action=عفوا ! <br> لايمكنك القيام بهذا الأمر , تأكد من الخيارات المتوفره 
weather=الطقس
vote=تصويت
Your city=المدينه 
temperaturef=فهرينهايتي
temperaturec=مئوي
Edit title for this page=عدل عنوان هذه الصفحة
Edit image for this page=صورة الصفحة إضافه أو تعديل 
Edit url for this page=أضف رابط لفتحه بدل هذه الصفحة عند الضغط على عنوان الصفحة بالثائمة 
save change url page=حفظ رابط هذه الصفحة 
change title page= عنوان الصفحة الجديد
url_self=فتح في نفس النافذه 
url_block=فتح في نافذه جديده
url_ajax=فتح في نافذه أجاكس 
enter  your form name=أدخل إسم النموذج 
my form=نموذجي 
withtitle=أظهر العنوان
withajax=تحميل كأجاكس
load options=خيارات التحميل
dynamic_static=ثابت
cachetype1=مؤقت 1
cachetype2=مؤقت 2
cachetype3=مؤقت 3
cachetype4=مؤقت 4
wdthbox=صندوق تصميم 
Done Update side View=تم تحديث الجوانب بنجاح
top1=علوي 1
top2=علوي 2
left1=يسار 1
left2=يسار 2
right1=يمين 1
right2=يمين 2
down1=سفلي 1
down2=سفلي 2
show side=تظهر في الجانب
postion= الترتيب
moderator=مشرف
green=أخضر
red=أحمر
orange=برتقالي
blue=أزرق
mobile=موبايل
square box=مجموعه , تتيح لك هذه الخاصيه تجميع مجموعه إضافات تتبع هذه المجموعه
side setting=إظهار الجوانب لهذه الصفحة
100 Box=صندوق تصميم 1
50 Box=صندوق تصميم 2
33 Box=صندوق تصميم 3
25 Box=صندوق تصميم 4
66 Box=صندوق تصميم 5
75 Box=صندوق تصميم 6
Bottons=أزرار
Wrapper patterns=نقشة الغلاف
Footer patterns=نقشة الذيل
Content patterns=نقشة المحتوى
Header patterns=نقشة التترويسه
Body patterns=نقشة الجسم
Footer shadows=ظلال الذيل
Content shadows=ظلال المحتوى
Header shadows=ظلال الترويسه
line Divisors=خط فاصل
Footer Divisors=فاصل الذيل
Content Divisors=فاصل المحتوى
Header Divisors=فاصل الترويسه
container Colors=لون الغلاف
Header Colors=لون الترويسه
Footer Colors=لون الذيل
body Colors=لون الجسم
Content Colors=لون المحتوى
Social Icons=أيقونات المواقع الإجتماعيه
Menu=قائمة رئيسيه
Search box=نموذج البحث
Top Shine=لمعان علوي
Logo=شعار
Top Bar=شريط علوي 
Font Style=تنسيق الخط
boxs=صناديق
patterns=نقوش
shadows=ظلال
Divisors=فواصل
header=ترويسه
color=ألوان
boxLinks=روابط لـ
boxtitle=عنوان لـ
boxContent=محتوى لـ
enabel disapld move resize=تفعيل وعدم تفعيل إمكانيه تحريك وتغيير أبعاد العناصر المضافه في الترويسه والذيل 
show hide other widget=إظهار وإخفاء العناصر المتوفره في صفحات أخرى للتحكم بها وإظهارها في هذه الصفحة 
Slider=بانر رئيسي 
nivoslider=بانر رئيسي 
show hide editor=تحرير النص أو جعله للقراءه فقط 
Orbit_redo=إعادة
Orbit_undo=تراجع
save change tree page=حفظ التفرعات الجديده
slave to=متفرعه من
Edit tree for this page=تعديل التفرع الخاص بهذه الصفحة 
root page tree=غير متفرعه
upload your file=تحميل ملف 
Are you sure?=هل أنت متأكد ؟ 
These items will be permanently deleted and cannot be recovered=سيتم الحذف ولن تكون قادرا على إسترجاعه , هل أنت متأكد ؟ 
Home Space=حجم الملفات
MySQL Space=حجم البيانات
Site IP=عنوان الموقع IP
disklimit=أقصى حجم
maxftp=أقصى عدد FTP
site ID=معرف الموقع
lay1=الشكل 1
lay2=الشكل 2
lay3=الشكل 3
lay4=الشكل 4
lay5=الشكل 5
lay6=الشكل 6
lay7=الشكل 7
lay8=الشكل 8
header-height=إرتفاع الترويسه
header-footer-height=ارتفاع الترويسه والذيل ونمط خارجي
footer-height=إرتفاع الذيل
control side page=التحكم في عرض الجوانب
margenside=محاذات الجوانب
copy from=نسخ من
Save Changes Style as defult=حفظ وجعلة كتنسيق إفتراضي 
delete Changes Style=حذف تنسيق هذه الصفحة
delete all Changes Style=حذف تنسيق جميع الصفحات
keywords= الكلمات المفتاحيه
discription for this page= وصف الصفحة
insert your new sub domain=أدخل النطاق الفرعي 
Cache page for=اخذ نسخة مؤقت لكل صفحة مدة
No cache Time=بدون نسخ مؤقته
Cache SQL for=أخذ نسخة مؤته من استعلامات قواعد البيانات لمدة 
Cache Widget for=أخذ نسخة مؤقته من ملفات القوالب لمدة
this widget show in pages=هذه الإضافه تظهر في هذه الصفحات 
this widget show in template=هذه الإضافه تظهر في هذه المجموعات 
this widget show in all=هذه الإضافه تظهر في جميع الصفحات والقوالب 
groupname=إسم المجموعه
this widget show in=أماكن ظهور الإضافه
this widget not show in=أماكن لا تظهر فيها الإضافه 
setting up this widget=إعدادات القوالب في هذه الإضافه
add template to this widget=أضف قالب لهذه الإضافه
select as default=إجعله الإفتراضي 
Edit this form=عدل هذا النموذج
use captcha=استخدام الكبتشا للحمايه
dont use=بدون الكبتشا 
fancy captcha=كبتشا خياليه
image captcha=كبتشا صوره 
Error image captcha=لقد قمت بإدخال شيفرة الحمايه  بشكل خاطئ 
re write code in image=أعد كتابه شيفرة الحمايه التي في الصورة لتأكيد أنك شخص 
useajaxadmin=تحميل الإضافات في صفحة المدير بطريقة الأجاكس؟
CMS Tool=أدوات المجله
Error password=خطأ في الرقم السري 
erase all style=حذف جميع التنسيقات
erase all template=حذف جميع القوالب
reset your site=إعادة الموقع فارغ وحذف جميع الصفحات والتنسيقات والصور 
Designer=مصمم
Developer=مطور
view as mobile mode=معاينة موبايل 
view as desktop mode=معاينة حاسوب شخصي
view as tablet mode=معاينة تابليت
menu_top_bar=قائمة علويه
managment option for css and widget=خيارات إضافيه للتحكم في التنسيقات والإضافات المستخدمه
header_menu_vertical= القائمة الرئيسيه عمودي
header_menu_horisantal= القائمة الرئيسيه أفقي 
Demo=تجريبي 
Registerd= مرخص
UnRegisterd=غير مرخص
licenType=نوع الترخيص
login_welcome=رساله ترحيبيه للمسجل
login=نماذج تسجيل شامله
width_size_full=عرض هذا الجزء ممتد على كامل الصفحة أو بحجم 1020 بكسل 
select template=إختر القالب 
create new template=أنشئ قالب جديد
name new template=إسم الفالب الجديد
Themer=المنسق
other=أخرى
where is show=أين تظهر ؟ 
changepaneltheme=تغيير الوان لوحة التحكم
overflowhide=إخفاء العناصر الخارجيه
padding use=إستخدام المحاذاة الداخليه
please wait=الرجاء الإنتظار
Quta=المساحة
Used=مستخدم
refresh_plugins=تحديث الإضافات
jsfiles=ملفات الجافاسكريبت
js file you dont load in user session=إعادة بناء ملف جافاسكريبت الرئيسي
None Compress=بدون ضغط
Numeric Compress=ضغط عادي
Normal Compress=ضغط متقدم
High ASCII Compress=ضغط عالي 
createjsfile=أنشئ الملف 
there are a new virsin from this plugin=يوجد إصدار جديد من هذه الإضافة
update=تحديث
use smart choice=استخدم الإختيار الذكي
we found=تم إيجاد 
files and update it successfuly=ملف بحاجة إلى تحديث ,  وقد تمت عملية التحديث بنجاح 
your site up to date=لديك موقع يحتوي على آخر التحديثات المتاحة
last update in=آخر تحديث تم في 
check fo updates=البحث عن تحديثات جديده
read more=إقرأ المزيد 
Note:you must save all work before update,page will be refrish=ملاحظه : يجب حفظ جميع التعديلات التي قمت بها قبل عملية التحديث , سيتم إعادة تحميل الصفحة
Update Now=قم بعملية التحديث الآن 
Click to see your files=أنظر إلى ملفاتك بالضغظ هنا
themer_icon_socials=أيكونات المواقع الإجتماعيه
themer_fullheader_menu_bar=قائمة علويه
themer_logo=الشعار
themer_search=مربع البحث
themer_container_menu=القائمة الرئيسيه
YOUR TEXT=النص الخاص بك هنا
Link sample=مثال لرابط
writer=الكاتب
title=عنوان
ic_facebook=رابط صفحتك على فيسبوك
ic_twitter=رابط حسابك على تويتر
ic_rss=رابط القصاصات
ic_mail=بريدك الإلكتروني
ic_plus=رابط صفحتك على جووجل بلس 
ic_linkedin=رابط صفحتك على لينكدن
ic_rssmail=رابط القائمة البريديه
ic_skype=رابط حساب سكايب 
random=عشوائي
xcream=مشرق
xdark=مظلم
xgreen=شجري
xlight=فاهي
xred=ناري
xblue=بحري