
right-left=right
@@@1=أهلا
@@@2=خروج
@@@3=ملفي 
@@@4=الرئيسيه
@@@5=العملاء
@@@6=الموظفون
@@@7=اللغات
@@@8=المدير
@@@9=ملف الإكسل
@@@10=أرسل
@@@11=مطلوب
@@@12=يجب أن يكون الملف المرفق أكسل ومرتب على حسب الترتيب الذي تم الإتفاق عليه
@@@13=التحكم وإدارة العملاء
@@@14=عميل تم إضافته بنجاح
@@@15=جاري إرسال البيانات .. الرجاء الإنتظار
@@@16=موظف
@@@17=مدير
@@@18=موقوف
@@@19=الإسم الكامل
@@@20=العنوان
@@@21=رقم الموبايل
@@@22=تاريخ الميلاد
@@@23=معلومات إضافيه
@@@24=يجب أن تكون جميع البيانات صحيحه وتتحمل أنت كامل المسؤوليه أمام القضاء
@@@25=شركة وائ العيساوي
@@@26=المعلومات الشخصيه
@@@27=جميع العملاء
@@@28=مكالمة هاتفيه
@@@29=لقاء
@@@30=دفعه
@@@31=موعد
@@@32=إتفاق
@@@33=إنهاء
@@@34=أحداث
@@@35=إغلاق
@@@36=حفظ
@@@37=المعلومات العامه
@@@38=إضافة حدث
@@@39=رجوع
@@@40=نوع الحدث
@@@41=المرفقات
@@@42=وقت الحدث
@@@43=تفاصيل الحدث
@@@44=ثانيه
@@@45=دقيقه
@@@46=ساعه
@@@47=يوم
@@@48=اسبوع
@@@49=شهر
@@@50=سنه
@@@51=قبل
@@@52=كتب قي
@@@53=بواسطه
@@@54=البريد الإلكتروني
@@@55=أضف موقع عنوانك على خريطة جووجل بالضغط على مكانك في الخريطه
@@@56=المبلغ
@@@57=المبلغ المراد تسديده
@@@58=يسدد على عدد الأشهر
@@@59=تذكير بالسداد في كل يوم من الشهر
@@@60=إعدادات
@@@61=التحكم في إعدادات البرنامج
@@@62=تغيير الرقم السري
@@@63=الرقم السري الحالي
@@@64=الرقم السري الجديد
@@@65=إعادة كتابة الرقم السري الجديد
@@@66=خطأ ... لم تقم بإدخال رقم سري متطابق
@@@67=تمت عمليه التحديث
@@@68=تنبيهات
@@@69=هل أنت متأكد من أنك تريد حذف هذا العميل وجميع الأحداث الخاصه به؟
@@@70=نعم
@@@71=لا
@@@72=
@@@73=
@@@74=
@@@75=
@@@76=
@@@77=
@@@78=

arrowrtl=&#9658;
forum_name_caption=forum_name_caption
forum_status_caption=forum_status_caption
forum_lastthread_caption=forum_lastthread_caption
add new thread=add new thread
forum_threads=forum_threads
forum_replys=forum_replys
forum_thread_in=forum_thread_in
forum_thread_by=forum_thread_by
go=go
mearge forum selected=mearge forum selected
delete forum and thread selected=delete forum and thread selected
add new sub forum=add new sub forum
add new forum=add new forum
new forum=new forum
new sub forum=new sub forum
about new forum=about new forum
new thread=new thread
content thread=content thread
alert=alert
are you soure wana delete this forum and all thread under it?=are you soure wana delete this forum and all thread under it?
subject_thread_caption=subject_thread_caption
outher_thread_caption=outher_thread_caption
forum_view=forum_view
delete thread selected=delete thread selected
mearge thread selected=mearge thread selected
close thread selected=close thread selected
pic thread selected=pic thread selected
add new thread=add new thread
please login or register to write a thread=please login or register to write a thread
hint_thread_caption=hint_thread_caption
save new thread=save new thread
reply thread=reply thread
all forums=all forums
&laquo;=&laquo;
delete thread=delete thread
close thread=close thread
pic thread=pic thread
Forum Colors=Forum Colors
Header Forum Colors=Header Forum Colors
Add a new slide=Add a new slide
slideurl=slideurl
done add slide=done add slide
Managment slides=Managment slides
Do you really want to delete slide=Do you really want to delete slide
option slider=option slider
url=url
height=height
width=width
showcounter=showcounter
hidecounter=hidecounter
done set slide=done set slide
slide_accordion=slide_accordion
slide_content=slide_content
slide_nivoslider=slide_nivoslider
comment=comment
Your name=Your name
Your email=Your email
Your site link=Your site link
Type number in image to text field=Type number in image to text field
Send your comment=Send your comment
Delete comment=Delete comment
Active Comment=Active Comment
deActive Comment=deActive Comment
your comment too short=your comment too short
Error securityImage=Error securityImage
all field requaird=all field requaird
your comment added=your comment added
Enable comment on this page=Enable comment on this page
Disable comment on this page=Disable comment on this page
Resume comment on this page=Resume comment on this page
Stop comment on this page=Stop comment on this page
Enable comment=Enable comment
Can comment=Can comment
Xsecond=Xsecond
Xminute=Xminute
Xhour=Xhour
Xday=Xday
Xweek=Xweek
Xmonth=Xmonth
Xyear=Xyear
Xdecade=Xdecade
ago=ago
header_menu_vertical=header_menu_vertical
header_menu_horisantal=header_menu_horisantal
menu=menu
add a new menu=add a new menu
menunamed=menunamed
menu style theme=menu style theme
side menu with style=side menu with style
normal menu without style=normal menu without style
done create menu!=done create menu!
mini_bar=mini_bar
side_social=side_social
recent_tweets=recent_tweets
Please upload images only and make sure your image size less than 1MB=Please upload images only and make sure your image size less than 1MB
Error with upload your image , sorry!=Error with upload your image , sorry!
Add a new image=Add a new image
defaultimage=defaultimage
image=image
login_form=login_form
register_form=register_form
reset_password_form=reset_password_form
member=member
Welcom=Welcom
Last login=Last login
member=member
is now as=is now as
not active=not active
active=active
privileges=privileges
admin_full=admin_full
admin_design=admin_design
admin_developer=admin_developer
admin_editor=admin_editor
Algeria=Algeria
Bahrain=Bahrain
Djibouti=Djibouti
Egypt=Egypt
Iraq=Iraq
Jordan=Jordan
Kuwait=Kuwait
Lebanon=Lebanon
Libya=Libya
Mauritania=Mauritania
Morocco=Morocco
Oman=Oman
Palestine=Palestine
Qatar=Qatar
Saudi Arabia=Saudi Arabia
Somalia=Somalia
Sudan=Sudan
Syria=Syria
Tunisia=Tunisia
UAE=UAE
Yemen=Yemen
Algiers=Algiers
Manama=Manama
Djibouti=Djibouti
Cairo=Cairo
BagdÄd=BagdÄd
AmmÄn=AmmÄn
Al-Kuwayt=Al-Kuwayt
BayrÅ«t=BayrÅ«t
Tripoli=Tripoli
Nouakchott=Nouakchott
Rabat=Rabat
Muscat=Muscat
Jerusalem=Jerusalem
Doha=Doha
Riyadh=Riyadh
Muqdisho=Muqdisho
Khartoum=Khartoum
Damascus=Damascus
Tunis=Tunis
Abu Dhabi=Abu Dhabi
Åžan'Ä=Åžan'Ä
Fajr=Fajr
Sunrise=Sunrise
Dhuhr=Dhuhr
Asr=Asr
Maghrib=Maghrib
Isha=Isha
xday=xday
pic a country=pic a country
islam_tools_salat=islam_tools_salat
islam_tools_hijrydate=islam_tools_hijrydate
type of counter=type of counter
text only=text only
image=image
flash=flash
add counter templates=add counter templates
color flash counter=color flash counter
choose show file=choose show file
show counter for=show counter for
todayvis=todayvis
nowvis=nowvis
allvis=allvis
viscounter=viscounter
preview=preview
Control panel=Control panel
Page=Page
Style=Style
Themes=Themes
Box=Box
Widget=Widget
Edit CSS=Edit CSS
Go to controlpanel , new page=Go to controlpanel , new page
Result show here for any change=Result show here for any change
this page option=this page option
Style or css live editor=Style or css live editor
chnage your site theme=chnage your site theme
add or delete or edit box in right or left colmuns=add or delete or edit box in right or left colmuns
add or delete or edit widget in header or footer=add or delete or edit widget in header or footer
Close this front panel=Close this front panel
Plugin=Plugin
Position=Position
Link To=Link To
select=select
relative=relative
fixed=fixed
static=static
Page=Page
Header=Header
Content=Content
Footer=Footer
run in=run in
All=All
This layout only=This layout only
This Page only=This Page only
show Powers=show Powers
Add a new box=Add a new box
Box title=Box title
Box content=Box content
Box Style=Box Style
Column side=Column side
Left=Left
Right=Right
Add Box now=Add Box now
Add widget now=Add widget now
edit this plugin file advance=edit this plugin file advance
Page option=Page option
Layout setting=Layout setting
Site option=Site option
Postion setting=Postion setting
postion_center=postion_center
postion_left=postion_left
postion_right=postion_right
Drag and drop this box=Drag and drop this box
Right click to show menu option=Right click to show menu option
Click to edit this page title=Click to edit this page title
Click to edit this page content=Click to edit this page content
Quick change image & color=Quick change image & color
Select section and click clear image & color=Select section and click clear image & color
Background=Background
left box header=left box header
right box header=right box header
Clear image & color=Clear image & color
you can pick image to=you can pick image to
Change=Change
Uploading image...=Uploading image...
Advance Editor CSS Theme=Advance Editor CSS Theme
Select section and click on Live Style Editor to modify=Select section and click on Live Style Editor to modify
Live Style Editor=Live Style Editor
Restore Orginal Style=Restore Orginal Style
header menu=header menu
search=search
left_box=left_box
right_box=right_box
Quick change font properties=Quick change font properties
Select section and modify font=Select section and modify font
Title page=Title page
Content page=Content page
Links=Links
Title box=Title box
Content box=Content box
Sample text style=Sample text style
Save Changes Style=Save Changes Style
from here you can change theme for your site=from here you can change theme for your site
Choose theme=Choose theme
general properties=general properties
settings=settings
save settings=save settings
withbox=withbox
withoutbox=withoutbox
widget controls=widget controls
templates=templates
cancel and Close=cancel and Close
Uploading=Uploading
Drop files here to upload=Drop files here to upload
Click to edit=Click to edit
apply=apply
Saving...=Saving...
add this widget to=add this widget to
control setting your site=control setting your site
controlplugin=controlplugin
code edit=code edit
Update widget done=Update widget done
Delete done=Delete done
Done sort=Done sort
Saved style Success=Saved style Success
Done Update Layout Postion=Done Update Layout Postion
Done Update Layout View=Done Update Layout View
Success apply theme=Success apply theme
Add widget done=Add widget done
Drag Editor=Drag Editor
Click to Bold=Click to Bold
Click to Italic=Click to Italic
Click to Underline=Click to Underline
Left Align=Left Align
Center Align=Center Align
Right Align=Right Align
Justify Align=Justify Align
Insert Ordered List=Insert Ordered List
Insert Unordered List=Insert Unordered List
Click to Subscript=Click to Subscript
Click to Superscript=Click to Superscript
Click to Strike Through=Click to Strike Through
Remove Formatting=Remove Formatting
Indent Text=Indent Text
Remove Indent=Remove Indent
Horizontal Rule=Horizontal Rule
Select Font Size=Select Font Size
Select Font Family=Select Font Family
Select Font Format=Select Font Format
Change Text Color=Change Text Color
Change Background Color=Change Background Color
Save this content=Save this content
Add Image=Add Image
Edit HTML=Edit HTML
Add Link=Add Link
Remove Link=Remove Link
press enter to save or ESC to cancel=press enter to save or ESC to cancel
bring_to_front=bring_to_front
send_to_back=send_to_back
bring_forward=bring_forward
send_backward=send_backward
refresh=refresh
pick template and select action=pick template and select action
Edit advance=Edit advance
you well delete this template and all widget use it, are you sure?=you well delete this template and all widget use it, are you sure?
you cant Delete the defult template!=you cant Delete the defult template!
no controlpanel for this widget=no controlpanel for this widget
my account=my account
my account setting=my account setting
Language choose=Language choose
Generate Style Editor=Generate Style Editor
generate Editor CSS Theme=generate Editor CSS Theme
Sfhati Control panel=Sfhati Control panel
rtl_ltr=ltr
right_left=left
left_right=right
arrowcss=▸
before_after=after
User=User
Setting Description=Setting Description
Setting Value= Setting Value
Setting Default Value=Setting Default Value
Setting Type=Setting Type
normal text=normal text
text erea=text erea
editor= editor
true & false=true & false
compo 1 to 100=compo 1 to 100
hiden= hiden
Use it in template?=Use it in template?
Yes= Yes
No= No
Page title=Page title
Description= Description
Add/Remove editor=Add/Remove editor
Content=Content
URL= URL
Image path=Image path
Sub under page id=Sub under page id
Reset= Reset
Cancel= Cancel
Sorry we have an error, <br> try agian=Sorry we have an error, <br> try agian
Loading...= Loading ...
saving...= saving ...
Click to edit...=Click to edit...
Please Select=Please Select
Close= Close
yes i wont delete=yes i wont delete
template= template
to do it=to do it
User Name=User Name
Password=Password
Forget password=Forget password
Login=Login
Add new=Add new
please try agean=please try agean
permission is denain!=permission is denain!
Add note=Add note
Upload Now=Upload Now
Link= Link
Accept template=Accept template
Manage template=Manage template
About template=About template
Delete template=Delete template
Preview template=Preview template
Active/Deactive=Active/Deactive
File is valid, and was successfully uploaded= File is valid, and was successfully uploaded
Possible file upload attack!=Possible file upload attack!
Update template site to=Update template site to
done...= done ...
Delete template=Delete template
Update new style=Update new style
sort done!=sort done!
Add new Page= Add new Page
Show pages by= Show pages by
template= template
[AND/OR] place=[AND/OR] place
Rows Nu= Rows No.
Page with out colums=Page without columns
Page with colums=Page with columns
Page with right colum=Page with right column
Page with left colum=Page with left column
Page with colums on right=Page with columns on the right
Page with colums on left=Page with columns on the left
GO=GO
Nu=No
Page title=Page title
Sort=Sort
Place=Place
Template=Template
Powers=Powers
Add sub=Add sub
Active=Active
Edit=Edit
Delete=Delete
Pages=Pages
show sub pages=show sub pages
P_Public=Public
Login= Login
Not Login=Not Login
Logout=Logout
Home= Home
Site template= Site template
Pages editor=Pages editor
Site setting=Site setting
Plugin`s=Plugin`s
Welcome=Welcome
Choose=Choose
Value=Value
Update= Update
Add New=Add New
Advance=Advance
Reset_defult=Reset defult
Pages=Pages
all pages=all pages
Zero mean under root=Zero mean under root
Save note=Save note
Your name= Your name
Text of the note=Text of the note
Color= Color
Template name=Template name
Plugin name=Plugin name
Delete plugin=Delete plugin
About plugin=About plugin
Manage plugin=Manage plugin
Click on=Click on
plugin=plugin
upload complete=upload complete
uploading=uploading
Upload new template=Upload new template
Upload new plugin=Upload new plugin
x__manag_template=Templates
x__plugin= Plugins
x__sett=Sittings
x__page=Page Management
main menu=Main
Options=Options
Last login=Last login
Help=Help
Language=Language
one column=One column
tow column=Tow column
three column=Three column
blank=Blank page
Email sitting=Email Settings
upload_dir=Upload Folder
template_dir=Template Folder
Statistic=Statistics
page managment add edit=Add/Edit Pages
File manager=File Manager
upload delete images & files=Manage Images & Files
Members=Members
Setting=Settings
Plugin=Plugins
Plugin control page=Plugins Control Panel
Information=Information
Main Domain=Main Domain
Last login from=Last login from
Disk space=Disk space
Monthly=Monthly
Read more=Read more
Add new email=Add New Email
emails=Emails
Email=Email
all emails=all emails
Create=Create
Install=Install
Downloads=Downloads
version=version
all plugins=all plugins
Plugin manage=Plugin manage
About=About
Add new member=Add new member
Active user message=Active user message
After active user message=After active user message
Msg name alredy register=Msg name alredy register
msg_email_alredy_register=msg_email_alredy_register
msg_must_fill_name=msg_must_fill_name
msg_must_fill_pass=msg_must_fill_pass
msg_must_fill_valid_email=msg_must_fill_valid_email
msg_register_done=msg_register_done
subject email active your account=subject email active your account
content email active your account=content email active your account
invaled_password=invaled_password
changed_password_done=changed_password_done
changed image done=changed image done
image file invaled=image file invaled
Save=Save
Name=Name
Send=Send
delete_page=delete_page
makehome_page=makehome_page
permition_page0=permition_page0
permition_page1=permition_page1
permition_page2=permition_page2
permition_page3=permition_page3
permition_page4=permition_page4
make=make
control place page=control place page
change site title=change site title
change icon site=change icon site
save change title site=save change title site
pages=pages
caption=caption
U_small=U_small
U_midiom=U_midiom
U_large=U_large
U_required=U_required
U_optional=U_optional
U_length=U_length
U_min=U_min
U_max=U_max
U_number=U_number
U_lette=U_lette
U_email=U_email
U_nospecialcaracters=U_nospecialcaracters
U_telephone=U_telephone
U_rege=U_rege
U_nothing=U_nothing
Save & Close=Save & Close
New password=New password
New textarea=New textarea
New checkbox=New checkbox
New file=New file
New radio=New radio
add item=add item
delete item=delete item
new item=new item
Verify that you are a human=Verify that you are a human
U_drag=U_drag
into the circle=into the circle
pencil=pencil
scissors=scissors
clock=clock
heart=heart
note=note
new_text=new_text
new_password=new_password
new_textarea=new_textarea
new_checkbox=new_checkbox
new_radio=new_radio
new_select=new_select
new_list=new_list
new_file=new_file
new_date_picker=new_date_picker
new_form=new_form
new_save=new_save
send form email notification=send form email notification
send_database form_builder=send_database form_builder
database form_builder=database form_builder
msg_after_send=msg_after_send
Thank you=Thank you
Success=Success
Error fancy captcha=Error fancy captcha
Between=Between
and=and
characters allowed=characters allowed
This field is required=This field is required
Please select an option=Please select an option
This checkbox is required=This checkbox is required
Checks allowed Exceeded=Checks allowed Exceeded
Please select=Please select
U_options=U_options
Your field is not matching=Your field is not matching
Invalid phone number=Invalid phone number
Invalid email address=Invalid email address
Invalid date, must be in YYYY-MM-DD format=Invalid date, must be in YYYY-MM-DD format
Numbers only=Numbers only
Available=Available
not Available=not Available
No special caracters allowed=No special caracters allowed
Letters only=Letters only
form_builder=form_builder
all record=all record
recordform=recordform
dont run in this page=dont run in this page
sorry u cant do this action=sorry u cant do this action
weather=weather
vote=vote
Your city=Your city
temperaturef=temperaturef
temperaturec=temperaturec
Edit title for this page=Edit title for this page
Edit image for this page=Edit image for this page
Edit url for this page=Edit url for this page
save change url page=save change url page
save change title page=save change title page
url_self=url_self
url_block=url_block
url_ajax=url_ajax
enter  your form name=enter  your form name
my form=my form
withtitle=withtitle
wdthbox=wdthbox
Done Update side View=Done Update side View
top1=top1
top2=top2
left1=left1
left2=left2
right1=right1
right2=right2
down1=down1
down2=down2
show side=show side
postion=postion
moderator=moderator
green=green
red=red
orange=orange
blue=blue
mobile=mobile
square box=square box
side setting=side setting
100 Box=100 Box
50 Box=50 Box
33 Box=33 Box
25 Box=25 Box
66 Box=66 Box
75 Box=75 Box
Bottons=Bottons
Wrapper patterns=Wrapper patterns
Footer patterns=Footer patterns
Content patterns=Content patterns
Header patterns=Header patterns
Body patterns=Body patterns
Footer shadows=Footer shadows
Content shadows=Content shadows
Header shadows=Header shadows
line Divisors=line Divisors
Footer Divisors=Footer Divisors
Content Divisors=Content Divisors
Header Divisors=Header Divisors
container Colors=container Colors
Header Colors=Header Colors
Footer Colors=Footer Colors
body Colors=body Colors
Content Colors=Content Colors
Social Icons=Social Icons
Menu=Menu
Search box=Search box
Top Shine=Top Shine
Logo=Logo
Top Bar=Top Bar
Font Style=Font Style
boxs=boxs
patterns=patterns
shadows=shadows
Divisors=Divisors
header=header
color=color
boxLinks=boxLinks
boxtitle=boxtitle
boxContent=boxContent
enabel disapld move resize=enabel disapld move resize
show hide other widget=show hide other widget
Slider=Slider
nivoslider=nivoslider
show hide editor=show hide editor
Orbit_redo=Orbit_redo
Orbit_undo=Orbit_undo
save change tree page=save change tree page
slave to=slave to
Edit tree for this page=Edit tree for this page
root page tree=root page tree
upload your file=upload your file
Are you sure?=Are you sure?
These items will be permanently deleted and cannot be recovered=These items will be permanently deleted and cannot be recovered
Home Space=Home Space
MySQL Space=MySQL Space
Site IP=Site IP
disklimit=disklimit
maxftp=maxftp
site ID=site ID
lay1=lay1
lay2=lay2
lay3=lay3
lay4=lay4
lay5=lay5
lay6=lay6
lay7=lay7
lay8=lay8
header-height=header-height
header-footer-height=header-footer-height
footer-height=footer-height
control side page=control side page
margenside=margenside
copy from=copy from
Save Changes Style as defult=Save Changes Style as defult
delete Changes Style=delete Changes Style
delete all Changes Style=delete all Changes Style
save keywords=save keywords
save discription for this page=save discription for this page
refresh_plugins=refresh_plugins
jsfiles=jsfiles
js file you dont load in user session=js file you dont load in user session
None Compress=None Compress
Numeric Compress=Numeric Compress
Normal Compress=Normal Compress
High ASCII Compress=High ASCII Compress
createjsfile=createjsfile
there are a new virsin from this plugin=there are a new virsin from this plugin
update=update
use smart choice=use smart choice
open ticket=open ticket
manage tickets=manage tickets
tickets=tickets
please login to access this service=please login to access this service
Subject=Subject
Message=Message
sales=sales
support=support
Department=Department
Send Now=Send Now
your ticket is send=your ticket is send
please fill all feilds=please fill all feilds
you have ticket not close yet=you have ticket not close yet
your ticket is error=your ticket is error
Ticket ID=Ticket ID
Last Updated=Last Updated
Create Date=Create Date
Status=Status
close_ticket=close_ticket
calendar=calendar
calendar result=calendar result
Select rows from=Select rows from
related with=related with
related in=related in
sorttype=sorttype
RANDOM=RANDOM
ASC=ASC
DESC=DESC
sortby=sortby
record no=record no
record counter in each page=record counter in each page
thefeild=thefeild
isas=isas
maintitle=maintitle
discription=discription
mainimage=mainimage
createddate=createddate
recordbody=recordbody
viewings=viewings
comments=comments
active=active
publishdate=publishdate
mainfieldsshow=mainfieldsshow
ifistatment=ifistatment
mosthave=mosthave
equal=equal
likethis=likethis
notequal=notequal
morethan=morethan
lessthan=lessthan
fieldand=fieldand
fieldor=fieldor
addnewstatment=addnewstatment
deletethisstatment=deletethisstatment
previw=previw
selecttemplate=selecttemplate
marquee.inc=marquee.inc
ddslick.inc=ddslick.inc
mosaic_block.inc=mosaic_block.inc
note: must publish view application in this page=note: must publish view application in this page
openinpagename=openinpagename
application name=application name
application type=application type
create application=create application
view application=view application
artical_text.inc=artical_text.inc
popular.inc=popular.inc
application=application
gallery=gallery
gallerylabom=gallerylabom
gallerylabomimg=gallerylabomimg
Add=Add
gallerylabomshow=gallerylabomshow
gallerylabomlist=gallerylabomlist
Add a new album=Add a new album
your album has been added successfully=your album has been added successfully
Get notified when we launch=Get notified when we launch
Notify Me=Notify Me
Sending your message. Please wait...=Sending your message. Please wait...
Thanks for sending your message! We'll get back to you shortly=Thanks for sending your message! We'll get back to you shortly
There was a problem sending your message. Please try again=There was a problem sending your message. Please try again
Please complete all the fields in the form before sending=Please complete all the fields in the form before sending
Please enter a valid email=Please enter a valid email
Lunche in=Lunche in
color is=color is
Title=Title
big Title=big Title
small Title=small Title
You can use this link to view your site as a guest=You can use this link to view your site as a guest
Your site logo=Your site logo
de active=de active
Send and active=Send and active
xYears=xYears
xMonths=xMonths
xWeeks=xWeeks
xDays=xDays
xHours=xHours
xMinutes=xMinutes
xSeconds=xSeconds
xYear=xYear
xMonth=xMonth
xWeek=xWeek
xDay=xDay
xHour=xHour
xMinute=xMinute
xSecond=xSecond
control section=control section
Add section=Add section
Add source=Add source
control source=control source
source name=source name
source discription=source discription
source image=source image
Section name=Section name
read more from archive=read more from archive
themer_icon_socials=themer_icon_socials
themer_fullheader_menu_bar=themer_fullheader_menu_bar
themer_logo=themer_logo
themer_search=themer_search
themer_container_menu=themer_container_menu
YOUR TEXT=YOUR TEXT
Link sample=Link sample
writer=writer
title=title
Results for=Results for
Total number of reuslts=Total number of reuslts
search_result=search_result
Add a new slide=Add a new slide
slideurl=slideurl
done add slide=done add slide
Managment slides=Managment slides
Do you really want to delete slide=Do you really want to delete slide
option slider=option slider
url=url
height=height
width=width
ads=ads
maillist=maillist
maillist form=maillist form
This wll sent to all Emails=This wll sent to all Emails
Subject=Subject
Message=Message
Manage Emails=Manage Emails
Send Email=Send Email
email title=email title
see your email=see your email
your mail has been successfuly added=your mail has been successfuly added
your email alredy in our mailing list=your email alredy in our mailing list
defaultparagraph=defaultparagraph
paragraph_editor=paragraph_editor
dynamic_paragraph_editor=dynamic_paragraph_editor
